{
    "maps" : [
        {
            "name" : "Map test 1",
            "width" : 38,
            "height" : 7,
            "content" : [
                "1  1  1  1  1  1  1  1  1  1  1  1  1  1  1  1  1  1  1  1  1  1  1  1  1  1  1  1  1  1  1  1  1  1  1  1  1  1",
                "1  0  0  0  0  0  0  0  0  0  0  0  0  0  0  0  0  0  0  0  0  0  0  0  0  0  0  0  0  0  0  0  0  0  0  0  0  1",
                "1  0  0  0  0  0  1  4  0  0  4  0  0  4  0  0  4  0  0  4  0  0  4  1  0  0  0  0  0  0  0  0  0  0  0  0  0  1",
                "1  0  0  0  0  0  1  0  1  1  0  1  1  0  1  1  0  1  1  0  1  1  0  1  0  0  0  0  0  0  0  0  0  0  0  0  0  1",
                "1  0  0  0  0  0  0  0  0  0  0  0  0  0  0  0  0  0  0  0  0  0  0  0  0  0  0  0  0  0  0  0  0  0  0  0  0  1",
                "1  0  0  0  0  0  0  0  0  0  0  0  0  0  0  0  0  0  0  0  0  0  0  0  0  0  0  0  0  0  0  0  0  0  0  0  0  1",
                "1  1  1  1  1  1  1  1  1  1  1  1  1  1  1  1  1  1  1  1  1  1  1  1  1  1  1  1  1  1  1  1  1  1  1  1  1  1"
            ]
        },
        {
            "name" : "Map test 2",
            "width" : 20,
            "height" : 20,
            "content" : [
                "1 1 1 1 1 1 1 1 1 1 1 1 1 1 1 1 1 1 1 1",
                "1 0 0 0 0 0 0 0 1 0 0 0 0 0 0 0 0 0 0 1",
                "1 0 0 0 0 0 0 0 1 0 0 0 0 0 0 0 0 0 0 1",
                "1 0 0 0 0 0 0 0 1 0 0 0 0 0 0 0 0 0 0 1",
                "1 1 0 0 0 0 0 0 1 0 0 0 0 1 0 0 0 0 0 1",
                "1 0 0 0 0 0 0 0 1 0 0 0 0 0 0 0 0 0 0 1",
                "1 0 0 0 0 0 0 0 1 0 0 0 0 0 0 0 0 0 0 1",
                "1 0 0 1 0 0 0 0 1 0 0 0 1 0 0 0 0 0 0 1",
                "1 0 0 0 0 0 0 0 1 0 0 0 0 0 0 0 0 0 0 1",
                "1 0 0 0 0 0 0 0 1 0 0 0 0 0 0 0 0 0 0 1",
                "1 1 1 1 1 1 0 0 0 0 0 1 1 1 1 1 1 1 1 1",
                "1 0 0 0 0 1 0 0 0 0 0 1 0 0 0 0 0 0 0 1",
                "1 0 0 0 0 1 0 0 0 0 0 1 0 0 0 0 0 0 0 1",
                "1 0 0 0 0 1 0/3 0/3 0/3 0/3 0/3 1 0 0 0 0 0 0 0 1",
                "1 0 0 0 0 1 0/3 0/3 0/3 0/3 0/3 1 0 0 0 0 0 0 0 1",
                "1 0 0 0 0 1 1 1 1 1 1 1 0 0 0 0 0 0 0 1",
                "1 0 0 0 0 0 0 0 0 1 0 0 0 0 0 0 0 0 0 1",
                "1 0 0 0 0 0 0 0 0 0 0 0 0 0 0 0 0 0 0 1",
                "1 0 0 0 0 0 0 0 0 0 0 0 0 0 0 0 0 0 0 1",
                "1 1 1 1 1 1 1 1 1 1 1 1 1 1 1 1 1 1 1 1"
            ]
        }
    ]
}